a	b
b	c
c	d
d	e
e	f
f	g
g	h
h	i
i	j
j	k
k	l
l	m
m	n
n	o
o	p
p	r
r	s
s	t
t	u
u	w
w	y
y	z
z	a
A	B
B	C
C	D
D	E
E	F
F	G
G	H
H	I
I	J
J	K
K	L
L	M
M	N
N	O
O	P
P	R
R	S
S	T
T	U
U	W
W	Y
Y	Z
Z	A
